.       .
..o o/...
b..\x ..o
..     \ 
.      .e