# 30
..2..x  .
  o4/t...
    \   .
e....   .
\      ..
\ .......
\  o   o 
t ./.../ 
.6..   .b
