# 40
   ..... ...  
.. .   .      
...2...b  ..  
 .  ..  e4....
....      .  .
   ..  2......
    . .1  .  .
    ...  .....
              